WWWWWWWWWWWWWWW
WVVVVVVVVVVVVVW
WWWWWWWVVVVVVVW
WVVVVVVVVVVVVVW
WVVWWWWWWWWWWWW
WVVVVVVVVVVVVVW
WVPVVVVVVVVVVVW
WWWWWWVVVVVVVVW
WVVVVVVVVVVVVVW
WWWWWWWWWWWWWWW
