WWWWWVVVVVWWWWW
WVVVVVVVVVVVVVW
WVVVVVVVVVVVVVW
VVVFVVVVVVVVVVV
VVVVVVVVVVVVVVV
VVVVVVVVVVVVVVV
VVPVVVVVVVVVVVV
WVVVVVVVVVVVVVW
WVVVVVVVVVVVVVW
WWWWWVVVVVWWWWW
